[
["河南省","河南"],
["山东省","山东"],
["辽宁省","辽宁"],
["吉林省","吉林"],
["北京市","北京"],
["天津市","天津"],
["河北省","河北"],
["陕西省","陕西"],
["山西省","山西"],
["黑龙江省","黑龙江"],
["上海市","上海"],
["内蒙古自治区","内蒙古"],
["广东省","广东"],
["贵州省","贵州"],
["江苏省","江苏"],
["浙江省","浙江"],
["安徽省","安徽"],
["福建省","福建"],
["江西省","江西"],
["湖南省","湖南"],
["宁夏回族自治区","宁夏"],
["新疆维吾尔自治区","新疆"],
["广西壮族自治区","广西"],
["海南省","海南"],
["重庆市","重庆"],
["四川省","四川"],
["甘肃省","甘肃"],
["云南省","云南"],
["西藏自治区","西藏"],
["湖北省","湖北"],
["青海省","青海"],
["台湾省","台湾"],
["香港特别行政区","香港"],
["澳门特别行政区","澳门"]
]